5 13 31
###############################
#p * *3       *  ** * *      *#
# # # # #*# # #*# # # # # #*# #
#    * * *** **  4   *    **  #
# #*# # # # #4# #b#1# # # # #*#
#          *     **      *  **#
# # #*# # # # # #*#*#*#*# # # #
#   *        *   * *x* *   4  #
# # # # #*# # # # # # #*# #*# #
#   ****         *2           #
# # # # # # # # # #*# # # # #*#
#  ** *4  *    2              #
###############################